#######
#S===E#
#=###=#
#=====#
####### 